1111111111111111111111111111111111111111
1000000000000000000100000000000000000011
1011111110111111110101111111101111111011
1011111110111111110101111111101111111011
1211111110111111110101111111101111111211
1011111110111111110101111111101111111011
1000000000000000000000000000000000000011
1011111110111110111111101111101111111011
1011111110111110111111101111101111111011
1000011110000110000100001100001111000011
1011000000110111110101111101100000011011
1011111110110111110101111101101111111011
1011000000000111110101111100000000011011
1000011110110000000000000001101111000011
1111111110110110111011101101101111111111
1111111110000110100000101100001111111111
1111111111110110100000101101111111111111
1111111111110110100000101101111111111111
1111111111110110111111101101111111111111
1111111111110000000000000001111111111111
1111111111110110111111101101111111111111
1111111111110110111111101101111111111111
1111111111110110000000001101111111111111
1111111111110110111011101101111111111111
1111111111110110111011101101111111111111
1000000000000000000000000000000000000011
1011111110110111111111111101101111111011
1011111110110111111111111101101111111011
1000000110110000001110000001101100000011
1111110110110111101110111101101101111111
1111110110110111101110111101101101111111
1000000110110111101110111101101100000011
1011110110110000000000000001101101111011
1011110110000111111111111100001101111011
1211110111110111111111111101111101111211
1011110000000000001110000000000001111011
1011110111111111101110111111111101111011
1011110111111111101110111111111101111011
1000000000000000000000000000000000000011
1111111111111111111111111111111111111111
1111111111111111111111111111111111111111